border_size=1
usage=map

Xos         , Xos         , Xos         , Xos         , Xos         , Xos         , Xos         , Xos         , Xos         , Xos         , Xos         , Xos         , Xos         , Xos         , Xos         , Xos         , Xos         , Xos         , Xos         , Xos         , Xos         
Xos         , Xos         , Xos         , Xos         , Xos         , Xos         , Xos         , Xos         , Xos         , Xos         , Qxu         , Xos         , Xos         , Xos         , Xos         , Xos         , Xos         , Xos         , Xos         , Xos         , Xos         
Xos         , Xos         , Xos         , Xos         , Xos         , Xos         , Xos         , Xos         , Qxu         , Qxu         , Ds          , Qxu         , Qxu         , Xos         , Xos         , Xos         , Xos         , Xos         , Xos         , Xos         , Xos         
Xos         , Xos         , 1 Qlf       , Xos         , Xos         , Xos         , Qxu         , Qxu         , Ds          , Gg          , Gg          , Gg          , Ds          , Qxu         , Qxu         , Xos         , Xos         , 2 Qlf       , Xos         , Xos         , Xos         
Xos         , Xos         , Xos         , Xos         , Qxu         , Qxu         , Hh          , Qxu         , Qxu         , Gg          , Ds          , Gg          , Qxu         , Qxu         , Hh          , Qxu         , Qxu         , Xos         , Xos         , Xos         , Xos         
Xos         , Xos         , Qxu         , Qxu         , Hh          , Hh          , Mm          , Uu          , Ds          , Qxu         , Qxu         , Qxu         , Ds          , Uu          , Mm          , Hh          , Hh          , Qxu         , Qxu         , Xos         , Xos         
Xos         , Qxu         , Uu          , Qxu         , Qxu         , Hh          , Hh          , Uu          , Ds          , Gg          , Gg          , Gg          , Ds          , Uu          , Hh          , Hh          , Qxu         , Qxu         , Uu          , Qxu         , Xos         
Xos         , Qxu         , Uu          , Uu          , Qxu         , Qxu         , Qxu         , Qxu         , Qxu         , Ds          , Gg          , Ds          , Qxu         , Qxu         , Qxu         , Qxu         , Qxu         , Uu          , Uu          , Qxu         , Xos         
Xos         , Qxu         , Qxu         , Qxu         , Gg          , Hh          , Mm          , Hh          , Gg          , Qxu         , Qxu         , Qxu         , Gg          , Hh          , Mm          , Hh          , Gg          , Qxu         , Qxu         , Qxu         , Xos         
Xos         , Qxu         , Qxu         , Gg          , Gg          , Hh          , Mm          , Hh          , Gg          , Gg          , Qxu         , Gg          , Gg          , Hh          , Mm          , Hh          , Gg          , Gg          , Qxu         , Qxu         , Xos         
Xos         , Qxu         , Uu          , Qxu         , Qxu         , Hh          , Qxu         , Hh          , Qxu         , Qxu         , Gg          , Qxu         , Qxu         , Hh          , Qxu         , Hh          , Qxu         , Qxu         , Uu          , Qxu         , Xos         
Xos         , Qxu         , Uu          , Uu          , Qxu         , Qxu         , Hh          , Qxu         , Ds          , Ds          , Gg          , Ds          , Ds          , Qxu         , Hh          , Qxu         , Qxu         , Uu          , Uu          , Qxu         , Xos         
Xos         , Qxu         , Qxu         , Qxu         , Hh          , Hh          , Mm          , Uu          , Ds          , Gg          , Qxu         , Gg          , Ds          , Uu          , Mm          , Hh          , Hh          , Qxu         , Qxu         , Qxu         , Xos         
Xos         , Xos         , Xos         , Qxu         , Qxu         , Hh          , Hh          , Uu          , Qxu         , Qxu         , Ds          , Qxu         , Qxu         , Uu          , Hh          , Hh          , Qxu         , Qxu         , Xos         , Xos         , Xos         
Xos         , 3 Qlf       , Xos         , Xos         , Xos         , Qxu         , Qxu         , Qxu         , Ds          , Gg          , Gg          , Gg          , Ds          , Qxu         , Qxu         , Qxu         , Xos         , Xos         , 4 Qlf       , Xos         , Xos         
Xos         , Xos         , Xos         , Xos         , Xos         , Xos         , Xos         , Qxu         , Qxu         , Gg          , Ds          , Gg          , Qxu         , Qxu         , Xos         , Xos         , Xos         , Xos         , Xos         , Xos         , Xos         
Xos         , Xos         , Xos         , Xos         , Xos         , Xos         , Xos         , Xos         , Xos         , Qxu         , Qxu         , Qxu         , Xos         , Xos         , Xos         , Xos         , Xos         , Xos         , Xos         , Xos         , Xos         
Xos         , Xos         , Xos         , Xos         , Xos         , Xos         , Xos         , Xos         , Xos         , Xos         , Xos         , Xos         , Xos         , Xos         , Xos         , Xos         , Xos         , Xos         , Xos         , Xos         , Xos         
