border_size=1
usage=map

Qxu         , Qxu         , Qxu         , Qxu         , Qxu         , Qxu         , Qxu         , Qxu         , Qxu         , Qxu         , Qxu         , Qxu         , Qxu         , Qxu         
Qxu         , Qxu         , Qxu         , Qxu         , Qxu         , 1 Qxu       , Qxu         , Qxu         , Qxu         , 2 Qxu       , Qxu         , Qxu         , Qxu         , Qxu         
Qxu         , Qxu         , Qxu         , Qxu         , Gg          , Qxu         , Gg          , Qxu         , Gg          , Qxu         , Gg          , Qxu         , Qxu         , Qxu         
Qxu         , Qxu         , Qxu         , Gg          , Ds          , Gg          , Ds          , Gg          , Ds          , Gg          , Ds          , Qxu         , Qxu         , Qxu         
Qxu         , Qxu         , Qxu         , Ds          , Gg          , Ds          , Gg          , Ds          , Gg          , Ds          , Gg          , Qxu         , Qxu         , Qxu         
Qxu         , Qxu         , Qxu         , Gg          , Ds          , Gg          , Ds          , Gg          , Ds          , Gg          , Ds          , Qxu         , Qxu         , Qxu         
Qxu         , Qxu         , Qxu         , Ds          , Gg          , Ds          , Gg          , Ds          , Gg          , Ds          , Gg          , Qxu         , Qxu         , Qxu         
Qxu         , Qxu         , Qxu         , Gg          , Ds          , Gg          , Ds          , Gg          , Ds          , Gg          , Ds          , Qxu         , Qxu         , Qxu         
Qxu         , Qxu         , Qxu         , Ds          , Gg          , Ds          , Gg          , Ds          , Gg          , Ds          , Gg          , Qxu         , Qxu         , Qxu         
Qxu         , Qxu         , Qxu         , Gg          , Ds          , Gg          , Ds          , Gg          , Ds          , Gg          , Ds          , Qxu         , Qxu         , Qxu         
Qxu         , Qxu         , Qxu         , Ds          , Qxu         , Ds          , Qxu         , Ds          , Qxu         , Ds          , Qxu         , Qxu         , Qxu         , Qxu         
Qxu         , Qxu         , Qxu         , Qxu         , 3 Qxu       , Qxu         , Qxu         , Qxu         , 4 Qxu       , Qxu         , Qxu         , Qxu         , Qxu         , Qxu         
Qxu         , Qxu         , Qxu         , Qxu         , Qxu         , Qxu         , Qxu         , Qxu         , Qxu         , Qxu         , Qxu         , Qxu         , Qxu         , Qxu         
