border_size=1
usage=map

Xv          , Xv          , Xv          , Xv          , Xv          , Xv          , Xv          , Xv          , Xv          , Xv          , Xv          , Xv          , Xv          , Xv          , Xv          , Xv          , Xv          , Xv          , Xv          , Xv          , Xv          , Xv          , Xv          , Xv          , Xv          , Xv          , Xv          , Xv          , Xv          , Xv          , Xv          , Xv          , Xv          , Xv          , Xv          , Xv          , Xv          , Xv          , Xv          
Xv          , Xv          , Xv          , Xv          , Xv          , Xv          , Xv          , Xv          , Xv          , Xv          , Xv          , Xv          , Xv          , Xv          , Xv          , Xv          , Xv          , Xv          , Xv          , Xv          , Xv          , Xv          , Xv          , Xv          , Xv          , Xv          , Xv          , Xv          , Xv          , Xv          , Xv          , Xv          , Xv          , Xv          , Xv          , Xv          , Xv          , Xv          , Xv          
Xv          , Xv          , Xv          , Xv          , Xv          , Xv          , Xv          , Xv          , Xos         , Xv          , Xos         , Xv          , Xos         , Xv          , Xos         , Xv          , Xos         , Xv          , Xos         , Xv          , Xos         , Xv          , Xos         , Xv          , Xos         , Xv          , Xos         , Xv          , Xos         , Xv          , Xos         , Xv          , Xv          , Xv          , Xv          , Xv          , Xv          , Xv          , Xv          
Xv          , Xv          , Xv          , Xv          , Xv          , Xv          , Xv          , Xos         , Cud         , Xos         , Cud         , Xos         , Cud         , Xos         , Cud         , Xos         , Cud         , Xos         , Cud         , Xos         , Cud         , Xos         , Cud         , Xos         , Cud         , Xos         , Cud         , Xos         , Cud         , Xos         , Cud         , Xos         , Xv          , Xv          , Xv          , Xv          , Xv          , Xv          , Xv          
Xv          , Xv          , Xv          , Xv          , Xv          , Xv          , Xv          , Xos         , Cud         , Cud         , Cud         , Cud         , Qxu         , Cud         , Qxu         , Cud         , Qxu         , Cud         , Qxu         , Cud         , Qxu         , Cud         , Qxu         , Cud         , Qxu         , Cud         , Qxu         , Cud         , Qxu         , Cud         , Cud         , Xos         , Xv          , Xv          , Xv          , Xv          , Xv          , Xv          , Xv          
Xv          , Xv          , Xv          , Xv          , Xv          , Xv          , Xv          , Xos         , Cud         , Cud         , Qxu         , Qxu         , Mm          , Qxu         , Hh          , Qxu         , Qxu         , Qxu         , Qxu         , Qxu         , Gg          , Qxu         , Ds          , Qxu         , Uu          , Qxu         , Qxu         , Qxu         , Uu          , Qxu         , Cud         , Xos         , Xv          , Xv          , Xv          , Xv          , Xv          , Xv          , Xv          
Xv          , Xv          , Xv          , Xv          , Xv          , Xv          , Xv          , Xos         , Cud         , Qxu         , Mm          , Gg          , Mm          , Mm          , Hh          , Gg          , Qxu         , Qxu         , Qxu         , Ds          , Mm          , Hh          , Gg          , Gg          , Qxu         , Qxu         , Qxu         , Uu          , Uu          , Qxu         , Cud         , Xos         , Xv          , Xv          , Xv          , Xv          , Xv          , Xv          , Xv          
Xv          , Xv          , Xv          , Xv          , Xv          , Xv          , Xv          , Xos         , Cud         , Qxu         , Hh          , Mm          , Qxu         , Qxu         , Qxu         , Qxu         , Qxu         , Qxu         , Qxu         , Qxu         , Qxu         , Gg          , Qxu         , Qxu         , Qxu         , Qxu         , Qxu         , Qxu         , Qxu         , Qxu         , Cud         , Xos         , Xv          , Xv          , Xv          , Xv          , Xv          , Xv          , Xv          
Xv          , Xv          , Xv          , Xv          , Xv          , Xv          , Xv          , Xos         , Cud         , Qxu         , Gg          , Hh          , Qxu         , Qxu         , Gg          , Qxu         , Uu          , Qxu         , Qxu         , Qxu         , Qxu         , Qxu         , Ds          , Ds          , Mm          , Uu          , Ds          , Qxu         , Qxu         , Qxu         , Cud         , Xos         , Xv          , Xv          , Xv          , Xv          , Xv          , Xv          , Xv          
Xv          , Xv          , Xv          , Xv          , Xv          , Xv          , Xv          , Xos         , Cud         , Qxu         , Qxu         , Qxu         , Qxu         , Gg          , Hh          , Ds          , Ds          , Uu          , Qxu         , Qxu         , Ds          , Uu          , Gg          , Gg          , Hh          , Gg          , Ds          , Qxu         , Qxu         , Qxu         , Cud         , Xos         , Xv          , Xv          , Xv          , Xv          , Xv          , Xv          , Xv          
Xv          , Xv          , Xv          , Xv          , Xv          , Xv          , Xv          , Xos         , Cud         , Qxu         , Qxu         , Qxu         , Uu          , Ds          , Gg          , Mm          , Qxu         , Qxu         , Qxu         , Qxu         , Uu          , Uu          , Uu          , Mm          , Gg          , Mm          , Gg          , Gg          , Qxu         , Qxu         , Cud         , Xos         , Xv          , Xv          , Xv          , Xv          , Xv          , Xv          , Xv          
Xv          , Xv          , Xol         , Xos         , Xol         , Xv          , Xv          , Xol         , Cud         , Qxu         , Gg          , Qxu         , Qxu         , Ds          , Qxu         , Qxu         , Qxu         , Qxu         , Hh          , Ds          , Ds          , Ds          , Ds          , Ds          , Ds          , Ds          , Ds          , Qxu         , Qxu         , Qxu         , Cud         , Xos         , Xv          , Xv          , Xol         , Xos         , Xol         , Xv          , Xv          
Xol         , Xol         , Iwr         , Iwr         , Iwr         , Xol         , Xol         , Xol         , Cud         , Qxu         , Ds          , Gg          , Qxu         , Qxu         , Qxu         , Qxu         , Uu          , Uu          , Mm          , Gg          , Gg          , Uu          , Gg          , Ds          , Uu          , Ds          , Qxu         , Qxu         , Uu          , Qxu         , Cud         , Xol         , Xol         , Xol         , Iwr         , Iwr         , Iwr         , Xol         , Xol         
Xol         , Iwr         , Iwr         , 1 Iwr       , Iwr         , Iwr         , Xos         , Xol         , Cud         , Qxu         , Uu          , Gg          , Qxu         , Qxu         , Uu          , Ds          , Gg          , Hh          , Gg          , Hh          , Mm          , Hh          , Uu          , Ds          , Qxu         , Qxu         , Qxu         , Gg          , Ds          , Qxu         , Cud         , Xos         , Xos         , Iwr         , Iwr         , 2 Iwr       , Iwr         , Iwr         , Xos         
Xv          , Xos         , Xos         , Iwr         , Xos         , Xol         , Xv          , Xol         , Cud         , Qxu         , Qxu         , Qxu         , Ds          , Ds          , Ds          , Ds          , Ds          , Uu          , Ds          , Gg          , Hh          , Uu          , Qxu         , Qxu         , Qxu         , Qxu         , Qxu         , Hh          , Gg          , Qxu         , Cud         , Xos         , Xv          , Xos         , Xos         , Iwr         , Xos         , Xos         , Xv          
Xv          , Xv          , Xv          , Xol         , Xv          , Xv          , Xv          , Xos         , Cud         , Qxu         , Qxu         , Qxu         , Gg          , Ds          , Gg          , Ds          , Uu          , Ds          , Uu          , Ds          , Qxu         , Qxu         , Qxu         , Qxu         , Gg          , Ds          , Uu          , Qxu         , Qxu         , Qxu         , Cud         , Xos         , Xv          , Xv          , Xv          , Xos         , Xv          , Xv          , Xv          
Xv          , Xv          , Xv          , Xv          , Xv          , Xv          , Xv          , Xos         , Cud         , Qxu         , Qxu         , Gg          , Ds          , Mm          , Hh          , Mm          , Gg          , Uu          , Ds          , Qxu         , Qxu         , Qxu         , Ds          , Mm          , Hh          , Ds          , Qxu         , Qxu         , Qxu         , Qxu         , Cud         , Xos         , Xv          , Xv          , Xv          , Xv          , Xv          , Xv          , Xv          
Xv          , Xv          , Xv          , Xv          , Xv          , Xv          , Xv          , Xos         , Cud         , Qxu         , Qxu         , Qxu         , Ds          , Gg          , Mm          , Gg          , Ds          , Uu          , Qxu         , Qxu         , Qxu         , Uu          , Uu          , Ds          , Gg          , Gg          , Qxu         , Qxu         , Gg          , Qxu         , Cud         , Xos         , Xv          , Xv          , Xv          , Xv          , Xv          , Xv          , Xv          
Xv          , Xv          , Xv          , Xv          , Xv          , Xv          , Xv          , Xos         , Cud         , Qxu         , Qxu         , Qxu         , Qxu         , Uu          , Qxu         , Ds          , Qxu         , Qxu         , Qxu         , Qxu         , Qxu         , Qxu         , Qxu         , Qxu         , Qxu         , Qxu         , Qxu         , Hh          , Hh          , Qxu         , Cud         , Xos         , Xv          , Xv          , Xv          , Xv          , Xv          , Xv          , Xv          
Xv          , Xv          , Xv          , Xv          , Xv          , Xv          , Xv          , Xos         , Cud         , Qxu         , Uu          , Qxu         , Qxu         , Qxu         , Qxu         , Qxu         , Gg          , Gg          , Mm          , Qxu         , Qxu         , Qxu         , Qxu         , Qxu         , Hh          , Qxu         , Mm          , Mm          , Mm          , Qxu         , Cud         , Xos         , Xv          , Xv          , Xv          , Xv          , Xv          , Xv          , Xv          
Xv          , Xv          , Xv          , Xv          , Xv          , Xv          , Xv          , Xos         , Cud         , Qxu         , Uu          , Uu          , Qxu         , Qxu         , Uu          , Gg          , Ds          , Hh          , Gg          , Ds          , Qxu         , Qxu         , Qxu         , Gg          , Hh          , Mm          , Mm          , Gg          , Qxu         , Qxu         , Cud         , Xos         , Xv          , Xv          , Xv          , Xv          , Xv          , Xv          , Xv          
Xv          , Xv          , Xv          , Xv          , Xv          , Xv          , Xv          , Xos         , Cud         , Qxu         , Qxu         , Qxu         , Qxu         , Qxu         , Qxu         , Qxu         , Qxu         , Qxu         , Qxu         , Qxu         , Qxu         , Qxu         , Qxu         , Qxu         , Qxu         , Qxu         , Qxu         , Qxu         , Cud         , Cud         , Cud         , Xos         , Xv          , Xv          , Xv          , Xv          , Xv          , Xv          , Xv          
Xv          , Xv          , Xv          , Xv          , Xv          , Xv          , Xv          , Xos         , Cud         , Cud         , Cud         , Cud         , Cud         , Cud         , Cud         , Cud         , Cud         , Cud         , Cud         , Cud         , Cud         , Cud         , Cud         , Cud         , Cud         , Cud         , Cud         , Cud         , Cud         , Cud         , Cud         , Xos         , Xv          , Xv          , Xv          , Xv          , Xv          , Xv          , Xv          
Xv          , Xv          , Xv          , Xv          , Xv          , Xv          , Xv          , Xos         , Xos         , Xos         , Xos         , Xos         , Xos         , Xos         , Xos         , Xos         , Xos         , Xos         , Xos         , Xos         , Xos         , Xos         , Xos         , Xos         , Xos         , Xos         , Xos         , Xos         , Xos         , Xos         , Xos         , Xos         , Xv          , Xv          , Xv          , Xv          , Xv          , Xv          , Xv          
Xv          , Xv          , Xv          , Xv          , Xv          , Xv          , Xv          , Xv          , Xv          , Xv          , Xv          , Xv          , Xv          , Xv          , Xv          , Xv          , Xv          , Xv          , Xv          , Xv          , Xv          , Xv          , Xv          , Xv          , Xv          , Xv          , Xv          , Xv          , Xv          , Xv          , Xv          , Xv          , Xv          , Xv          , Xv          , Xv          , Xv          , Xv          , Xv          
Xv          , Xv          , Xv          , Xv          , Xv          , Xv          , Xv          , Xv          , Xv          , Xv          , Xv          , Xv          , Xv          , Xv          , Xv          , Xv          , Xv          , Xv          , Xv          , Xv          , Xv          , Xv          , Xv          , Xv          , Xv          , Xv          , Xv          , Xv          , Xv          , Xv          , Xv          , Xv          , Xv          , Xv          , Xv          , Xv          , Xv          , Xv          , Xv          
Xv          , Xv          , Xv          , Xv          , Xv          , Xv          , Xv          , Xv          , Xv          , Xv          , Xv          , Xv          , Xv          , Xv          , Xv          , Xv          , Xv          , Xv          , Xv          , Xv          , Xv          , Xv          , Xv          , Xv          , Xv          , Xv          , Xv          , Xv          , Xv          , Xv          , Xv          , Xv          , Xv          , Xv          , Xv          , Xv          , Xv          , Xv          , Xv          
