border_size=1
usage=map

Qxu         , Qxu         , Qxu         , Qxu         , Qxu         , Qxu         , Qxu         , Qxu         , Qxu         , Qxu         , Qxu         , Qxu         , Qxu         , Qxu         , Qxu         , Qxu         
Qxu         , Qxu         , Qxu         , Qxu         , Ds          , Qxu         , Qxu         , Qxu         , Qxu         , Qxu         , Qxu         , Qxu         , Qxu         , Qxu         , 2 Qxu       , Qxu         
Qxu         , Qxu         , Hh          , Mm          , Gg          , Uu          , Ds          , Qxu         , Qxu         , Qxu         , Qxu         , Qxu         , Hh          , Qxu         , Qxu         , Qxu         
Qxu         , Qxu         , Mm          , Hh          , Mm          , Ds          , Ds          , Ds          , Qxu         , Qxu         , Uu          , Uu          , Gg          , Hh          , Qxu         , Qxu         
Qxu         , Qxu         , Ds          , Gg          , Ds          , Gg          , Hh          , Ds          , Ds          , Qxu         , Ds          , Ds          , Ds          , Uu          , Qxu         , Qxu         
Qxu         , Qxu         , Uu          , Uu          , Uu          , Ds          , Qxu         , Uu          , Uu          , Qxu         , Ds          , Uu          , Uu          , Uu          , Qxu         , Qxu         
Qxu         , Qxu         , Uu          , Ds          , Ds          , Ds          , Qxu         , Ds          , Ds          , Hh          , Gg          , Ds          , Gg          , Ds          , Qxu         , Qxu         
Qxu         , Qxu         , Hh          , Gg          , Uu          , Uu          , Qxu         , Qxu         , Ds          , Ds          , Ds          , Mm          , Hh          , Mm          , Qxu         , Qxu         
Qxu         , Qxu         , Qxu         , Hh          , Qxu         , Qxu         , Qxu         , Qxu         , Qxu         , Ds          , Uu          , Gg          , Mm          , Hh          , Qxu         , Qxu         
Qxu         , 1 Qxu       , Qxu         , Qxu         , Qxu         , Qxu         , Qxu         , Qxu         , Qxu         , Qxu         , Qxu         , Ds          , Qxu         , Qxu         , Qxu         , Qxu         
Qxu         , Qxu         , Qxu         , Qxu         , Qxu         , Qxu         , Qxu         , Qxu         , Qxu         , Qxu         , Qxu         , Qxu         , Qxu         , Qxu         , Qxu         , Qxu         
Qxu         , Qxu         , Qxu         , Qxu         , Qxu         , Qxu         , Qxu         , Qxu         , Qxu         , Qxu         , Qxu         , Qxu         , Qxu         , Qxu         , Qxu         , Qxu         
