border_size=1
usage=map

Xos         , Xos         , Xos         , Xos         , Xos         , Xos         , Xos         , Xos         , Xos         , Xos         , Xos         , Xos         , Xos         , Xos         , Xos         , Xos         , Xos         , Xos         , Xos         , Xos         , Xos         , Xos         , Xos         , Xos         , Xos         
Xos         , Xos         , Xos         , Xos         , Xos         , Xos         , Xos         , Xos         , Xos         , Xos         , Xos         , Xos         , Xos         , Xos         , Xos         , Xos         , Xos         , Xos         , Xos         , Xos         , Xos         , Xos         , Xos         , Xos         , Xos         
Xos         , Xos         , Xos         , Xos         , Xos         , Xos         , Xos         , Xos         , Xos         , Xos         , Xos         , Xos         , Xos         , Xos         , Xos         , Xos         , Xos         , Xos         , Xos         , Xos         , Xos         , Xos         , Xos         , Xos         , Xos         
Xos         , Xos         , Xos         , Xos         , Xos         , Xos         , Xos         , Xos         , Xos         , Xos         , Xos         , Xos         , Xos         , Xos         , Xos         , Xos         , Xos         , Xos         , Xos         , Xos         , Xos         , Xos         , Xos         , Xos         , Xos         
Xos         , Xos         , Xos         , Xos         , Xos         , Xos         , Xos         , Xos         , Xos         , Xos         , Xos         , Xos         , Xos         , Xos         , Xos         , Xos         , Xos         , Xos         , Xos         , Xos         , Xos         , Xos         , Xos         , Xos         , Xos         
Xos         , Xos         , Xos         , Xos         , Xos         , Xos         , Xos         , Xos         , Xos         , Xos         , Xos         , Xos         , Qxu         , Xos         , Xos         , Xos         , Xos         , Xos         , Xos         , Xos         , Xos         , Xos         , Xos         , Xos         , Xos         
Xos         , Xos         , Xos         , Xos         , Xos         , Xos         , Xos         , Xos         , Xos         , Xos         , Qxu         , Qxu         , Re          , Qxu         , Qxu         , Xos         , Xos         , Xos         , Xos         , Xos         , Xos         , Xos         , Xos         , Xos         , Xos         
Xos         , Xos         , Xos         , Xos         , 1 Qlf       , Xos         , Xos         , Xos         , Qxu         , Qxu         , Re          , Ds          , Ds          , Ds          , Re          , Qxu         , Qxu         , Xos         , Xos         , 2 Qlf       , Xos         , Xos         , Xos         , Xos         , Xos         
Xos         , Xos         , Xos         , Xos         , Xos         , Xos         , Qxu         , Qxu         , Gg          , Qxu         , Qxu         , Ds          , Re          , Ds          , Qxu         , Qxu         , Gg          , Qxu         , Qxu         , Xos         , Xos         , Xos         , Xos         , Xos         , Xos         
Xos         , Xos         , Xos         , Xos         , Qxu         , Qxu         , Gg          , Gg          , Hh          , Uu          , Re          , Qxu         , Qxu         , Qxu         , Re          , Uu          , Hh          , Gg          , Gg          , Qxu         , Qxu         , Xos         , Xos         , Xos         , Xos         
Xos         , Xos         , Xos         , Qxu         , Uu          , Qxu         , Qxu         , Gg          , Gg          , Uu          , Re          , Ds          , Ds          , Ds          , Re          , Uu          , Gg          , Gg          , Qxu         , Qxu         , Uu          , Qxu         , Xos         , Xos         , Xos         
Xos         , Xos         , Xos         , Qxu         , Uu          , Uu          , Qxu         , Qxu         , Qxu         , Qxu         , Qxu         , Re          , Ds          , Re          , Qxu         , Qxu         , Qxu         , Qxu         , Qxu         , Uu          , Uu          , Qxu         , Xos         , Xos         , Xos         
Xos         , Xos         , Xos         , Qxu         , Qxu         , Qxu         , Ds          , Gg          , Hh          , Gg          , Ds          , Qxu         , Qxu         , Qxu         , Ds          , Gg          , Hh          , Gg          , Ds          , Qxu         , Qxu         , Qxu         , Xos         , Xos         , Xos         
Xos         , Xos         , Xos         , Qxu         , Qxu         , Ds          , Ds          , Gg          , Hh          , Gg          , Ds          , Ds          , Qxu         , Ds          , Ds          , Gg          , Hh          , Gg          , Ds          , Ds          , Qxu         , Qxu         , Xos         , Xos         , Xos         
Xos         , Xos         , Xos         , Qxu         , Uu          , Qxu         , Qxu         , Gg          , Qxu         , Gg          , Qxu         , Qxu         , Ds          , Qxu         , Qxu         , Gg          , Qxu         , Gg          , Qxu         , Qxu         , Uu          , Qxu         , Xos         , Xos         , Xos         
Xos         , Xos         , Xos         , Qxu         , Uu          , Uu          , Qxu         , Qxu         , Gg          , Qxu         , Re          , Re          , Ds          , Re          , Re          , Qxu         , Gg          , Qxu         , Qxu         , Uu          , Uu          , Qxu         , Xos         , Xos         , Xos         
Xos         , Xos         , Xos         , Qxu         , Qxu         , Qxu         , Gg          , Gg          , Hh          , Uu          , Re          , Ds          , Qxu         , Ds          , Re          , Uu          , Hh          , Gg          , Gg          , Qxu         , Qxu         , Qxu         , Xos         , Xos         , Xos         
Xos         , Xos         , Xos         , Xos         , Xos         , Qxu         , Qxu         , Gg          , Gg          , Uu          , Qxu         , Qxu         , Re          , Qxu         , Qxu         , Uu          , Gg          , Gg          , Qxu         , Qxu         , Xos         , Xos         , Xos         , Xos         , Xos         
Xos         , Xos         , Xos         , 3 Qlf       , Xos         , Xos         , Xos         , Qxu         , Qxu         , Qxu         , Re          , Ds          , Ds          , Ds          , Re          , Qxu         , Qxu         , Qxu         , Xos         , Xos         , 4 Qlf       , Xos         , Xos         , Xos         , Xos         
Xos         , Xos         , Xos         , Xos         , Xos         , Xos         , Xos         , Xos         , Xos         , Qxu         , Qxu         , Ds          , Re          , Ds          , Qxu         , Qxu         , Xos         , Xos         , Xos         , Xos         , Xos         , Xos         , Xos         , Xos         , Xos         
Xos         , Xos         , Xos         , Xos         , Xos         , Xos         , Xos         , Xos         , Xos         , Xos         , Xos         , Qxu         , Qxu         , Qxu         , Xos         , Xos         , Xos         , Xos         , Xos         , Xos         , Xos         , Xos         , Xos         , Xos         , Xos         
Xos         , Xos         , Xos         , Xos         , Xos         , Xos         , Xos         , Xos         , Xos         , Xos         , Xos         , Xos         , Xos         , Xos         , Xos         , Xos         , Xos         , Xos         , Xos         , Xos         , Xos         , Xos         , Xos         , Xos         , Xos         
Xos         , Xos         , Xos         , Xos         , Xos         , Xos         , Xos         , Xos         , Xos         , Xos         , Xos         , Xos         , Xos         , Xos         , Xos         , Xos         , Xos         , Xos         , Xos         , Xos         , Xos         , Xos         , Xos         , Xos         , Xos         
Xos         , Xos         , Xos         , Xos         , Xos         , Xos         , Xos         , Xos         , Xos         , Xos         , Xos         , Xos         , Xos         , Xos         , Xos         , Xos         , Xos         , Xos         , Xos         , Xos         , Xos         , Xos         , Xos         , Xos         , Xos         
Xos         , Xos         , Xos         , Xos         , Xos         , Xos         , Xos         , Xos         , Xos         , Xos         , Xos         , Xos         , Xos         , Xos         , Xos         , Xos         , Xos         , Xos         , Xos         , Xos         , Xos         , Xos         , Xos         , Xos         , Xos         
