border_size=1
usage=map

Xos         , Xos         , Xos         , Xos         , Xos         , Xos         , Xos         , Xos         , Xos         , Xos         , Xos         , Xos         , Xos         , Xos         , Xos         , Xos         , Xos         , Xos         , Xos         , Xos         , Xos         , Xos         , Xos         , Xos         , Xos         
Xos         , Xos         , Xos         , Xos         , Xos         , Xos         , Xos         , Xos         , Xos         , Xos         , Xos         , Xos         , Xos         , Xos         , Xos         , Xos         , Xos         , Xos         , Xos         , Xos         , Xos         , Xos         , Xos         , Xos         , Xos         
Xos         , Xos         , Xos         , Xos         , Xos         , Xos         , Xos         , Xos         , Xos         , Xos         , Xos         , Xos         , Xos         , Xos         , Xos         , Xos         , Xos         , Xos         , Xos         , Xos         , Xos         , Xos         , Xos         , Xos         , Xos         
Xos         , Xos         , Xos         , Xos         , Xos         , Xos         , Xos         , Xos         , Xos         , Xos         , Xos         , Xos         , Xos         , Xos         , Xos         , Xos         , Xos         , Xos         , Xos         , Xos         , Xos         , Xos         , Xos         , Xos         , Xos         
Xos         , Xos         , Xos         , Xos         , Xos         , Xos         , Xos         , Xos         , Xos         , Xos         , Xos         , Xos         , Qxu         , Xos         , Xos         , Xos         , Xos         , Xos         , Xos         , Xos         , Xos         , Xos         , Xos         , Xos         , Xos         
Xos         , Xos         , Xos         , Xos         , Xos         , Xos         , Xos         , Xos         , Xos         , Xos         , Qxu         , Qxu         , Qxu         , Qxu         , Qxu         , Xos         , Xos         , Xos         , Xos         , Xos         , Xos         , Xos         , Xos         , Xos         , Xos         
Xos         , Xos         , Xos         , Xos         , Xos         , Xos         , Xos         , Xos         , Qxu         , Qxu         , Uu          , Uu          , Uu          , Qxu         , Qxu         , Qxu         , Qxu         , Xos         , Xos         , Xos         , 2 Qlf       , Xos         , Xos         , Xos         , Xos         
Xos         , Xos         , Xos         , 1 Qlf       , Xos         , Xos         , Qxu         , Qxu         , Uu          , Uu          , Hh          , Hh          , Hh          , Uu          , Uu          , Qxu         , Qxu         , Qxu         , Qxu         , Xos         , Xos         , Xos         , Xos         , Xos         , Xos         
Xos         , Xos         , Xos         , Xos         , Qxu         , Qxu         , Uu          , Uu          , Gg          , Gg          , Ds          , Re          , Re          , Re          , Qxu         , Qxu         , Uu          , Qxu         , Qxu         , Qxu         , Qxu         , Xos         , Xos         , Xos         , Xos         
Xos         , Xos         , Xos         , Qxu         , Uu          , Uu          , Hh          , Ds          , Gg          , Gg          , Qxu         , Qxu         , Qxu         , Qxu         , Qxu         , Qxu         , Qxu         , Uu          , Uu          , Qxu         , Qxu         , Xos         , Xos         , Xos         , Xos         
Xos         , Xos         , Xos         , Qxu         , Uu          , Hh          , Hh          , Re          , Re          , Qxu         , Ds          , Ds          , Gg          , Hh          , Gg          , Ds          , Ds          , Qxu         , Qxu         , Uu          , Qxu         , Xos         , Xos         , Xos         , Xos         
Xos         , Xos         , Xos         , Qxu         , Qxu         , Uu          , Uu          , Re          , Qxu         , Qxu         , Qxu         , Ds          , Gg          , Hh          , Gg          , Ds          , Qxu         , Qxu         , Qxu         , Uu          , Qxu         , Xos         , Xos         , Xos         , Xos         
Xos         , Xos         , Xos         , Qxu         , Qxu         , Qxu         , Qxu         , Qxu         , Gg          , Gg          , Qxu         , Qxu         , Qxu         , Hh          , Qxu         , Qxu         , Gg          , Gg          , Qxu         , Uu          , Qxu         , Xos         , Xos         , Xos         , Xos         
Xos         , Xos         , Xos         , Qxu         , Qxu         , Uu          , Qxu         , Gg          , Qxu         , Qxu         , Gg          , Hh          , Gg          , Qxu         , Qxu         , Gg          , Qxu         , Qxu         , Uu          , Qxu         , Qxu         , Xos         , Xos         , Xos         , Xos         
Xos         , Xos         , Xos         , Qxu         , Qxu         , Uu          , Qxu         , Qxu         , Ds          , Ds          , Gg          , Hh          , Gg          , Ds          , Ds          , Qxu         , Re          , Re          , Hh          , Uu          , Uu          , Xos         , Xos         , Xos         , Xos         
Xos         , Xos         , Xos         , Qxu         , Qxu         , Uu          , Uu          , Qxu         , Qxu         , Ds          , Qxu         , Hh          , Qxu         , Ds          , Qxu         , Qxu         , Gg          , Re          , Hh          , Hh          , Uu          , Xos         , Xos         , Xos         , Xos         
Xos         , Xos         , Xos         , Qxu         , Qxu         , Qxu         , Qxu         , Uu          , Uu          , Qxu         , Qxu         , Qxu         , Re          , Qxu         , Gg          , Gg          , Gg          , Gg          , Uu          , Uu          , Qxu         , Xos         , Xos         , Xos         , Xos         
Xos         , Xos         , Xos         , Xos         , Xos         , Qxu         , Qxu         , Qxu         , Qxu         , Qxu         , Uu          , Re          , Hh          , Re          , Hh          , Gg          , Uu          , Uu          , Qxu         , Qxu         , Xos         , Xos         , Xos         , Xos         , Xos         
Xos         , Xos         , Xos         , 3 Qlf       , Xos         , Xos         , Xos         , Qxu         , Qxu         , Qxu         , Qxu         , Uu          , Uu          , Hh          , Uu          , Uu          , Qxu         , Qxu         , Xos         , Xos         , 4 Qlf       , Xos         , Xos         , Xos         , Xos         
Xos         , Xos         , Xos         , Xos         , Xos         , Xos         , Xos         , Xos         , Xos         , Qxu         , Qxu         , Qxu         , Qxu         , Uu          , Qxu         , Qxu         , Xos         , Xos         , Xos         , Xos         , Xos         , Xos         , Xos         , Xos         , Xos         
Xos         , Xos         , Xos         , Xos         , Xos         , Xos         , Xos         , Xos         , Xos         , Xos         , Xos         , Qxu         , Qxu         , Qxu         , Xos         , Xos         , Xos         , Xos         , Xos         , Xos         , Xos         , Xos         , Xos         , Xos         , Xos         
Xos         , Xos         , Xos         , Xos         , Xos         , Xos         , Xos         , Xos         , Xos         , Xos         , Xos         , Xos         , Xos         , Xos         , Xos         , Xos         , Xos         , Xos         , Xos         , Xos         , Xos         , Xos         , Xos         , Xos         , Xos         
Xos         , Xos         , Xos         , Xos         , Xos         , Xos         , Xos         , Xos         , Xos         , Xos         , Xos         , Xos         , Xos         , Xos         , Xos         , Xos         , Xos         , Xos         , Xos         , Xos         , Xos         , Xos         , Xos         , Xos         , Xos         
Xos         , Xos         , Xos         , Xos         , Xos         , Xos         , Xos         , Xos         , Xos         , Xos         , Xos         , Xos         , Xos         , Xos         , Xos         , Xos         , Xos         , Xos         , Xos         , Xos         , Xos         , Xos         , Xos         , Xos         , Xos         
Xos         , Xos         , Xos         , Xos         , Xos         , Xos         , Xos         , Xos         , Xos         , Xos         , Xos         , Xos         , Xos         , Xos         , Xos         , Xos         , Xos         , Xos         , Xos         , Xos         , Xos         , Xos         , Xos         , Xos         , Xos         
