border_size=1
usage=map

Xos         , Xos         , Xos         , Xos         , Xos         , Xos         , Xos         , Xos         , Xos         , Xos         , Xos         , Xos         , Xos         , Xos         , Xos         , Xos         , Xos         , Xos         , Xos         , Xos         , Xos         , Xos         , Xos         , Xos         , Xos         
Xos         , Xos         , Xos         , Xos         , Xos         , Xos         , Xos         , Xos         , Xos         , Xos         , Xos         , Xos         , Xos         , Xos         , Xos         , Xos         , Xos         , Xos         , Xos         , Xos         , Xos         , Xos         , Xos         , Xos         , Xos         
Xos         , Xos         , Xos         , Xos         , Xos         , Xos         , Xos         , Xos         , Xos         , Xos         , Xos         , Xos         , Xos         , Xos         , Xos         , Xos         , Xos         , Xos         , Xos         , Xos         , Xos         , Xos         , Xos         , Xos         , Xos         
Xos         , Xos         , Xos         , Xos         , Xos         , Xos         , Xos         , Xos         , Xos         , Xos         , Xos         , Xos         , Xos         , Xos         , Xos         , Xos         , Xos         , Xos         , Xos         , Xos         , Xos         , Xos         , Xos         , Xos         , Xos         
Xos         , Xos         , Xos         , Xos         , Xos         , Xos         , Xos         , Xos         , Xos         , Xos         , Xos         , Xos         , Uu          , Xos         , Xos         , Xos         , Xos         , Xos         , Xos         , Xos         , Xos         , Xos         , Xos         , Xos         , Xos         
Xos         , Xos         , Xos         , Xos         , Xos         , Xos         , Xos         , Xos         , Xos         , Xos         , Uu          , Uu          , Uu          , Uu          , Uu          , Xos         , Xos         , Xos         , Xos         , Xos         , Xos         , Xos         , Xos         , Xos         , Xos         
Xos         , Xos         , Xos         , Xos         , Xos         , Xos         , Xos         , Xos         , Uu          , Uu          , Re          , Re          , Re          , Uu          , Uu          , Uu          , Uu          , Xos         , Xos         , Xos         , 2 Qlf       , Xos         , Xos         , Xos         , Xos         
Xos         , Xos         , Xos         , 1 Qlf       , Xos         , Xos         , Uu          , Uu          , Re          , Re          , Hh          , Hh          , Hh          , Re          , Re          , Uu          , Uu          , Uu          , Uu          , Xos         , Xos         , Xos         , Xos         , Xos         , Xos         
Xos         , Xos         , Xos         , Xos         , Uu          , Uu          , Re          , Re          , Gg          , Gg          , Ds          , Gg          , Gg          , Gg          , Uu          , Uu          , Re          , Uu          , Uu          , Uu          , Uu          , Xos         , Xos         , Xos         , Xos         
Xos         , Xos         , Xos         , Uu          , Re          , Re          , Hh          , Ds          , Gg          , Gg          , Uu          , Uu          , Uu          , Uu          , Uu          , Uu          , Uu          , Re          , Re          , Uu          , Uu          , Xos         , Xos         , Xos         , Xos         
Xos         , Xos         , Xos         , Uu          , Re          , Hh          , Hh          , Gg          , Gg          , Uu          , Ds          , Ds          , Gg          , Hh          , Gg          , Ds          , Ds          , Uu          , Uu          , Re          , Uu          , Xos         , Xos         , Xos         , Xos         
Xos         , Xos         , Xos         , Uu          , Uu          , Re          , Re          , Gg          , Uu          , Uu          , Uu          , Ds          , Gg          , Hh          , Gg          , Ds          , Uu          , Uu          , Uu          , Re          , Uu          , Xos         , Xos         , Xos         , Xos         
Xos         , Xos         , Xos         , Uu          , Uu          , Uu          , Uu          , Uu          , Hh          , Hh          , Uu          , Uu          , Uu          , Hh          , Uu          , Uu          , Hh          , Hh          , Uu          , Re          , Uu          , Xos         , Xos         , Xos         , Xos         
Xos         , Xos         , Xos         , Uu          , Uu          , Re          , Uu          , Hh          , Uu          , Uu          , Gg          , Hh          , Gg          , Uu          , Uu          , Hh          , Uu          , Uu          , Re          , Uu          , Uu          , Xos         , Xos         , Xos         , Xos         
Xos         , Xos         , Xos         , Uu          , Uu          , Re          , Uu          , Uu          , Ds          , Ds          , Gg          , Hh          , Gg          , Ds          , Ds          , Uu          , Gg          , Gg          , Hh          , Re          , Re          , Xos         , Xos         , Xos         , Xos         
Xos         , Xos         , Xos         , Uu          , Uu          , Re          , Re          , Uu          , Uu          , Ds          , Uu          , Hh          , Uu          , Ds          , Uu          , Uu          , Gg          , Gg          , Hh          , Hh          , Re          , Xos         , Xos         , Xos         , Xos         
Xos         , Xos         , Xos         , Uu          , Uu          , Uu          , Uu          , Re          , Re          , Uu          , Uu          , Uu          , Gg          , Uu          , Gg          , Gg          , Gg          , Gg          , Re          , Re          , Uu          , Xos         , Xos         , Xos         , Xos         
Xos         , Xos         , Xos         , Xos         , Xos         , Uu          , Uu          , Uu          , Uu          , Uu          , Re          , Gg          , Hh          , Gg          , Hh          , Gg          , Re          , Re          , Uu          , Uu          , Xos         , Xos         , Xos         , Xos         , Xos         
Xos         , Xos         , Xos         , 3 Qlf       , Xos         , Xos         , Xos         , Uu          , Uu          , Uu          , Uu          , Re          , Re          , Hh          , Re          , Re          , Uu          , Uu          , Xos         , Xos         , 4 Qlf       , Xos         , Xos         , Xos         , Xos         
Xos         , Xos         , Xos         , Xos         , Xos         , Xos         , Xos         , Xos         , Xos         , Uu          , Uu          , Uu          , Uu          , Re          , Uu          , Uu          , Xos         , Xos         , Xos         , Xos         , Xos         , Xos         , Xos         , Xos         , Xos         
Xos         , Xos         , Xos         , Xos         , Xos         , Xos         , Xos         , Xos         , Xos         , Xos         , Xos         , Uu          , Uu          , Uu          , Xos         , Xos         , Xos         , Xos         , Xos         , Xos         , Xos         , Xos         , Xos         , Xos         , Xos         
Xos         , Xos         , Xos         , Xos         , Xos         , Xos         , Xos         , Xos         , Xos         , Xos         , Xos         , Xos         , Xos         , Xos         , Xos         , Xos         , Xos         , Xos         , Xos         , Xos         , Xos         , Xos         , Xos         , Xos         , Xos         
Xos         , Xos         , Xos         , Xos         , Xos         , Xos         , Xos         , Xos         , Xos         , Xos         , Xos         , Xos         , Xos         , Xos         , Xos         , Xos         , Xos         , Xos         , Xos         , Xos         , Xos         , Xos         , Xos         , Xos         , Xos         
Xos         , Xos         , Xos         , Xos         , Xos         , Xos         , Xos         , Xos         , Xos         , Xos         , Xos         , Xos         , Xos         , Xos         , Xos         , Xos         , Xos         , Xos         , Xos         , Xos         , Xos         , Xos         , Xos         , Xos         , Xos         
Xos         , Xos         , Xos         , Xos         , Xos         , Xos         , Xos         , Xos         , Xos         , Xos         , Xos         , Xos         , Xos         , Xos         , Xos         , Xos         , Xos         , Xos         , Xos         , Xos         , Xos         , Xos         , Xos         , Xos         , Xos         
